1111111111111
10000000000C1
1010000000011
1P100000001E1
1111111111111