1111111111111111111111
10000000000C0000000001
1001111111000001110101
1P000000000E1110101001
1111111111111111111111