1111111111111111111111
11000000000C0000010001
1000000011010011000111
1P100000000E1110101001
100000111000C111100001
1000000000000011100001
1000000000000011100001
1000000000000000000001
1111111111111111111111