1111111111111
10010000000C1
1000011110001
1P0011E0C0001
1111111111111