1111111111111111111111
1100000001000000010001
1000000000100110011111
10000000000E1110101001
10000011110001111000P1
1111110111000111000001
1000000000000011100001
100000000000000C000001
1111111111111111111111