1111111111111111111111
1100C00C010C0000010001
1C0000C000100110001111
1PC000C0000E1110101001
1C0000111100C111100001
1111110111000111000011
1000000C0C00C011100001
1000000000C0000000C001
1111111111111111111111