1111111111111111111111
11000000000C0000010001
1001111111000011111111
1P100000000E1110111001
1111111111111111111111